ADX	ADX
AroonDown	AroonDown
AroonOsc	AroonOsc
AroonUp	AroonUp
BollingerDown	BollingerDown
BollingerMid	BollingerMid
BollingerUp	BollingerUp
BollingerWidth	BollingerWidth
ChaikinMoneyFlow	ChaikinMoneyFlow
ChaikinVolatility	ChaikinVolatility
ChandeMomentum	ChandeMomentum
DEMA	DEMA
DirectionalIndicatorMinus	DirectionalIndicatorMinus
DirectionalIndicatorPlus	DirectionalIndicatorPlus
EaseOfMovement	EaseOfMovement
ElliotWaveOscillator	ElliotWaveOscillator
EnvelopeDown	EnvelopeDown
EnvelopeMid	EnvelopeMid
EnvelopeUp	EnvelopeUp
HHV	HHV
HullMA	HullMA
KAMA	KAMA
KeltnerDown	KeltnerDown
KeltnerUp	KeltnerUp
KlingerOsc	KlingerOsc
LLV	LLV
LinearReg	LinearReg
LinearRegSlope	LinearRegSlope
MA	MA
MACD	MACD
MassIndex	MassIndex
Momentum	Momentum
MoneyFlowIndex	MoneyFlowIndex
PriceChannelDown	PriceChannelDown
PriceChannelUp	PriceChannelUp
QQEF	QQEF
Qstick	Qstick
RSI	RSI
StochasticFast	StochasticFast
StochasticSlow	StochasticSlow
TEMA	TEMA
TRIX	TRIX
WilliamsR	WilliamsR